{
  "width": 20,
  "height": 11,
  "grid": [
    "┌──────────────────┐",
    "│                  ¦",
    "│                  ¦",
    "│                  ¦",
    "│                  ¦",
    "│      ╺══▶        ¦",
    "│                  ¦",
    "│                  ¦",
    "│                  ¦",
    "│                  ¦",
    "└==================┘"
  ]
}