{
  "height": 16,
  "width": 20,
  "grid": [
    "┌──────────────────┐",
    "│             *    ¦",
    "│                  ¦",
    "│                  ¦",
    "│                  ¦",
    "│                  ¦",
    "│                  ¦",
    "│                  ¦",
    "│        ▲         ¦",
    "│        ║         ¦",
    "│    ╔═══╝         ¦",
    "│    ║             ¦",
    "│    ╚╸       *    ¦",
    "│                  ¦",
    "│                  ¦",
    "└==================┘"
  ]
}
